########################################################################################################################
#                                                                                                                      #
#                                                                                                                      #
#                                                                                                                      #
#                                                                                                                      #
#                                                                                                                      #
#   D DDDDDDDDDDDDDDD                                                                                                  #
#    DDDDDDDDDDDDDDDDDL                                                                                                #
#                                                                                                                      #
#                                                                                                                      #
#                                                                                                                      #
#                                                                                                                      #
########################################################################################################################
971746804693646583974907236114489234019204891688710939209759842690127402024955448463828359389921314971767021767177336444036428353920135027168358142109594430287521622700585244711964054810908444859456276525852137035406602628073741696504406019706293566752172425842606002966329556401523395948701338597567789433598056810000942528920454900667940535842574473633191161027692306402076671839073059991583715726358230450929533283241502871693602492194852051271325267605446560169484598769569234033721022001470478161305548672738398834832663654468163612602539721148022976046772578257066290421468365535346949633167943542
E 118 7 All
