#############
#     DDD   #
#    DD     #
#     DD    #
#    DDD    #
#    DD     #
#   DDD     #
#    DD     #
#    DD     #
#  D D D    #
#    DD     #
#    DD     #
#    D      #
#    L      #
#           #
#           #
#           #
#           #
#           #
#           #
#           #
#           #
#           #
#           #
#           #
#           #
#           #
#           #
#           #
#           #
#           #
#           #
#           #
#           #
#           #
#           #
#           #
#           #
#           #
#           #
#           #
#           #
#           #
#           #
#           #
#           #
#           #
#           #
#           #
#           #
#           #
#           #
#           #
#           #
#           #
#           #
#           #
#           #
#           #
#           #
#           #
#           #
#           #
#           #
#           #
#           #
#           #
#           #
#           #
#           #
#           #
#           #
#           #
#           #
#           #
#           #
#           #
#           #
#           #
#           #
#           #
#           #
#           #
#           #
#           #
#           #
#           #
#           #
#           #
#           #
#           #
#           #
#           #
#           #
#           #
#           #
#           #
#           #
#           #
#           #
#           #
#           #
#           #
#           #
#           #
#           #
#           #
#           #
#           #
#           #
#           #
#           #
#           #
#           #
#           #
#           #
#           #
#           #
#           #
#           #
#############
863774937505463630216176339459093806834509386971242209858187845876616785610272996372988939931150414195367021926963374685684643402815658150207481575560736862314623319264367968091855644474596177862327282891555032690869512910269598646411509761037349205043431481686685091640768217620740947473524436158475101363105128056262374200887897758674249372732831573419631585513924107305917379839447019719518668367506030858284594297581833314048605375156257689362205119412662199231393558847665306761287991589157375193548257755380944168431323940522044404651702884648253167099838239055621213427608600147925845993153070584
E 7 2 All
