###############
#             #
#             #
#             #
#             #
#             #
#   ### ###   #
#             #
#             #
#             #
#     #       #
#     #       #
#     #PPPPL  #
#     #PPPP   #
###############
0
A 2 5 4 2 All
E 2 12 All
