##############################
#  PP               #        #
#  PPL              #        #
###############   ###   ###  #
#      #      #   ##      #  #
#      #      #   ##      #  #
#      #      #   ##      #  #
#      #      #   ##      #  #
#      #      #   ##      #  #
#      #      #   ##      #  #
#      #      #   ##      #  #
#      #      #   ##      #  #
#      #      #   ##      #  #
#      #      #   ##      #  #
#      #      #   ##      #  #
#      #      #   ##      #  #
#      #      #   ##      #  #
#      #      #   ##      #  #
#      #      #   ##      #  #
#      #      #   ##      #  #
#      #      #   ##      #  #
#      #      #   ##      #  #
#      #      #   ##      #  #
#      #      #   ##      #  #
#      #      #   ##      #  #
#      #      #   ##      #  #
#      #      #           #  #
#      #      #           #  #
#      #      #           #  #
##############################
863774937505463630198616839513182160111993245863281733269025327598623222667063163295413148674995235165479269793812200701395321625558802157308466998507578037149194297640934686689474203401942867557484586890031540766648028977224098021847677322620078448184694220495229806155889394392984270240718337198759420610362867812391808662941817612308231587934436012220300524818010992999182095768366933057294970313197322186274838423845357269824516452852472515941274120350218627592051715108476734932918902590444444190698250777277875197209740559714752361181658415304666781429685401772296835517283677574681910345592116537
E 28 1 All