##############################
#     D     D       L        #
#    DDDD   D D D            #
#    DDD   DDDDDD            #
#     DDD DDDDD              #
#      D                     #
#                            #
#                            #
#                            #
#                            #
#                            #
#                            #
#                            #
#                            #
#                            #
#                            #
#                            #
#                            #
#                            #
#                            #
#                            #
#                            #
#                            #
#                            #
#                            #
#                            #
#                            #
#                            #
#                            #
##############################
215943734376365907552580793202614147815057893250495628714090842755468877859640264490903578407258716293043756635732584384833655198632472068464803634771759714511053896668031345627393923550942273173739923269629768179723487441650653545311240457938196268086807949042284590850602806751372549802625856202639239823421494057268161966848431470511502371930095161652374910094013686388497020315646421613134695160929984797459310336551757340416709464180181873805229548395912268222647250280103338412165875884139878407882485268833942422033443254058365862188513134036860131581395054741787763926893586443887435321828364861
E 28 1 All