###################
#  PPL            #
#  PP             #
#      #          #
#      #          #
##   ##########   #
#      #      #   #
#      #      #   #
#      #      #   #
#      #      #   #
#      #      #   #
###################
0
A 15 10 17 8 All
E 17 1 All