#########################################################
#             #                                         #
#             #                                         #
#             #                                         #
#             #   ###################################   #
#             #   #                                 #   #
#             #   #                                 #   #
#             #   #                                 #   #
#             #   #                                 #   #
###############   #                                 #   #
#             L   #                                     #
#       DD        #                                     #
#       D DDDDD   #                                     #
#       D      D  #                                     #
#  DD   DD      D #                                     #
# DD D D D        #                                     #
#            D    #                                     #
#       D         #                                     #
#                 #                                     #
#########################################################
755803070317280676445739109506423948500306351915798265253982577762458633626956616990863026692791156798297334015080019604687747591233222290892642534787772840644001990532978878544993894304960526135850207047300607858201466998312641867040412873449372633852190470666988876004385760048757090005799378689856602520782069313030477297126290706229501264896417130812310021666590270907247059176184893045248804932978666173251251724760284485757485828570652168542381489370778516856117133915480448679988116856104598787633896370535265745709039458044028946213405297516280928285586350092480310192265529469401561618668954746
E 22 7 All