###########################################
#                                         #
#                                         #
#                                        L#
#                                         #
#                                         #
###########################################
0
E 1 3 All
