####################################################################################################
#                                                                                                  #
#                                                                                                  #
#                                                                                                  #
#                                                                                                  #
#                                                                                                  #
#                                                                                                  #
#                                                                                                  #
#                                                                                                  #
#                                                                                                  #
#                                                                                                  #
#                                                                                                  #
#                                                                                                  #
#      ########################################################################################   ##
#                                                       #                                          #
#                                                       #                                          #
#                                                       #                                          #
#                                                       #           D       D     DD      DD       #
#                                                       #                                          #
#                                                       #            D      DD    DD      DD       #
#                                                       #                                          #
#                                                       #           D     DD      DD      DD       #
#                                                       #                                          #
#                                                       #           D     DD      DD      DD       #
#                                                       #                                          #
#                                                       # L         D     DD      DD      DD       #
####################################################################################################
1511606140634561352838799719175112956834016182907170925989565127747049982668353330947100650145756136413893354537364528840966265942582901421879114698317426871800991122155729212831403801004672623112811158820965170972886708204129050935836707239139501551406134264122863679965942476661305565587278869890549751035477798483847794986056738291508716287661938861818463339080254191753963993637974477285226012044540617854924680338279720369698121727567563593034326133916183418915737574430613957038261819761203459962774161781644443980860083854787040152217500724295016935740504002956147460119804868424904986603698272691
L 94 9 10 All
L 80 20 10 All
L 3 20 10 All
L 53 6 10 All
E 2 2 All