####################################################################################################
#                                                                                                  #
#                                                                                                  #
#                                                                                                  #
#   ###########################################################################################   ##
#                                                       #           D       D     DD      DD       #
#                                                       #                                          #
#                                                       #            D      DD    DD      DD       #
#####################################################   #                                          #
#                                  #                    #           D     DD      DD      DD       #
#                                  #                    #                                          #
#                                                       #           D     DD      DD      DD       #
#               #                                       #                                          #
#               #                                       # L         D     DD      DD      DD       #
####################################################################################################
1403634273446378399080068822519717529649320678189702196637958729111889893914049165354584496730713373604038617003183363877914898510279275854902821753105269668771521715361632529604715328355665588678784970811545394074643808308574929152488524380248582467146154893113045798996715025193868057941038332147256799131533190206506138283937110544081265174127980055273087031924671127434364125506147104406739358710910390775748355310060368082206267050808640326084907678666120701249300571167167555300657447074466981701134276777890928364662775797041834649457681854413259095794037434848289851885520964296837502346168383923
L 78 12 5 All
L 55 1 5 All
E 2 2 All
