###############
#     #    LPP#
#           PP#
#     #       #
###############
0
E 1 2 All
