############################################################
#DD #     #            #   #                               #
# DD#     #            #   #                               #
# DD#     #            #   #                               #
# D #     #   ######   #   #     ###########################
#  D#     #   #    #   #   #     ###########################
# DD#     #   #    #   #####     ###########################
#  L#######   #    #             ###########################
#             #    #             ###########################
#             #    #             ###########################
############################################################
1187690539070012491527488029317103381834580085739025176340213194464300747965953799126173003672152382351303418826677183889193490027377313830436538227877538785877751063568327822403430474001256357855461960784028763533904885983300235212523160583869942051431148106626042223022424340792141329909864743676786147798578251174535984628516185514304679196367465119253003953797957101924596843743657056199212292270029859599786201066199248919431490135154528028781979721784503351854010035684716145199452033401425255271325122540731756392127149675530526499649825306621762012058810480488691810060190482875194113371962944114
E 55 9 All