############################################################
#   #     #            #   #                               #
#   #     #            #   #                               #
#   #     #            #   #                               #
#   #     #   ######   #   #     ###########################
#   #     #   #    #   #   #     ###########################
# DD#######   #    #   #####     ###########################
#  L          #    #             ###########################
#             #    #             ###########################
#             #    #             ###########################
############################################################
1187690539070012491527488029317103381834580085739025176340213194464300747965953799126173003672152382351303418826677183889193490027377313830436538227877538785877751063568327822403430474001256357855461960784028763533904885983300235212523160583869942051431148106626042223022424340792141329909864743676786147798578251174535984628516185514304679196367465119253003953797957101924596843743657056199212292270029859880973978770872762454748757339258088212785713335512668604279251017456155383863749046097616406375256540193011248855961722156731769009048937102608376761273610799087801488656300385171288384428938439282
E 55 9 All