################################################################################################################
#               #                                                                                              #
#    L                                                                                                         #
#                                                                                                              #
#               #                                                                                              #
#               #                                                                                              #
#               ################################################################################################
#               #                                                                                              #
#               #                                                                                              #
#               #                                                                                              #
#               #                                                                                              #
#               #                                                                                              #
#               #                                                                                              #
#               #                                                                                              #
#               #                                                                                              #
#               #                                                                                              #
################################################################################################################
2591324812516390890549025185350448755740805323436311814543547465099248695911702981674178736787905222792224192394426056984706780390505800327337232169259641984189570626557706000475651428979880625762826421915033243468714180567081549787893861008798653388781729729639582537708549614562967055596619010123158593303997512627416150155979512513993478076824937495083065282945689876567111551487027132745858166553591398981787121263814052245902380359849460829280776905212463013472958206948392180587679236875554340128629429532281471873843087668410754987297092500337197761703037854078777995739482995693040422101827251566
L 3 13 0 Front All
L 30 12 0 Back All
E 110 13 All
