################################################################
#               #                                              #
#    L                                                         #
#                                                              #
#               #                                              #
#               #                                              #
#               ##########################################     #
#               #                                        #     #
#               #                                        #     #
#               #                                        #     #
#               #                                        #     #
#               #                                        #     #
#               #                                        #     #
#               #                                        #     #
#               #                                        #     #
#               #                                        #     #
################################################################
2159437343763659075438010432296583244536411722966060862113541304733569666020709581819752708252016550865640212001234467923387562420313336725327692932919701393325879107348035266927577929783541656322701809507883164794920535430023997703814740029777742448978370460874003524834995811581309006347173158717584184378914010989223946941049573879844972690372989930499837209719950284177577163579179981540185810188782374699302190427306029461390698477140795821240925799431239272002651062476743473026172474360051573358653329568111959570943157314039617038336622703277830409741012324070627100425807805479965774807529869036
L 3 13 0 Front All
L 30 12 0 Front All
G 60 13 0 Front All
E 60 1 All
